                 
      ########  
      #     #   
      #    #    
      #####      
                 
   ###########    
     #       #    
###  # ##### #   
 ##  #     # #      
     ####### #
               
##############  
               
## ###    
   # #    
   ###    
         
       
